1131412311
1        1
3  22    3
4  1     4
3        1
1231     3
1        1
3 1      1
1 2      2
1511333331